*********
*   *   *
*       *
*    ****
***    **
*       *
*     ***
E    S  *
*********