*E*******
*       *
*   *****
*   *   *
*   *****
*       *
**      *
*      S*
*********