*********
*   *   *
**  *   *
*    * **
****** **
*       *
******* *
E    S  *
*********