*********
**      *
*  *  ***
*     ***
***   ***
***     *
***   ***
E    S **
*********