*********
*       *
**    S *
*      **
*********
*       *
**      *
E       *
*********